#date,total,failure,success,github-unique,github-dupe,other,none
2019-05-06,534,20,237,257,393,63,78
2019-05-07,532,19,236,255,391,63,78
2019-05-08,533,19,237,256,392,63,78
2019-05-09,533,19,238,257,392,63,78
2019-05-10,533,19,238,257,392,63,78
2019-05-11,533,19,238,257,392,63,78
2019-05-12,533,19,238,257,392,63,78
2019-05-13,534,19,239,258,393,63,78
2019-05-14,534,19,239,258,393,63,78
2019-05-15,534,19,239,258,393,63,78
2019-05-16,534,19,240,259,394,62,78
2019-05-17,535,19,241,260,395,62,78
2019-05-18,535,19,241,260,395,62,78
2019-05-19,535,18,241,259,395,62,78
2019-05-20,536,18,242,260,396,62,78
2019-05-21,536,18,242,260,396,62,78
2019-05-22,0,0,0,0,0,0,0
2019-05-23,539,17,244,261,397,65,77
2019-05-24,538,17,243,260,396,65,77
2019-05-25,538,17,244,261,398,63,77
2019-05-26,539,17,244,261,397,65,77
2019-05-27,539,17,245,262,398,64,77
2019-05-28,540,17,245,262,398,65,77
2019-05-29,540,17,245,262,398,65,77
2019-05-30,540,17,245,262,398,65,77
2019-05-31,541,17,246,263,399,65,77
2019-06-01,542,17,247,264,400,65,77
2019-06-02,543,16,249,265,401,65,77
