#date,total,failure,success,github-unique,github-dupe,other,none
2019-05-06,534,20,237,257,393,63,78
2019-05-07,532,19,236,255,391,63,78
2019-05-08,533,19,237,256,392,63,78
2019-05-09,533,19,238,257,392,63,78
2019-05-10,533,19,238,257,392,63,78
2019-05-11,533,19,238,257,392,63,78
2019-05-12,533,19,238,257,392,63,78
2019-05-13,534,19,239,258,393,63,78
2019-05-14,534,19,239,258,393,63,78
2019-05-15,534,19,239,258,393,63,78
2019-05-16,534,19,240,259,394,62,78
2019-05-17,535,19,241,260,395,62,78
2019-05-18,535,19,241,260,395,62,78
2019-05-19,535,18,241,259,395,62,78
2019-05-20,536,18,242,260,396,62,78
2019-05-21,536,18,242,260,396,62,78
2019-05-22,0,0,0,0,0,0,0
2019-05-23,539,17,244,261,397,65,77
2019-05-24,538,17,243,260,396,65,77
2019-05-25,538,17,244,261,398,63,77
2019-05-26,539,17,244,261,397,65,77
2019-05-27,539,17,245,262,398,64,77
2019-05-28,540,17,245,262,398,65,77
2019-05-29,540,17,245,262,398,65,77
2019-05-30,540,17,245,262,398,65,77
2019-05-31,541,17,246,263,399,65,77
2019-06-01,542,17,247,264,400,65,77
2019-06-02,543,16,249,265,401,65,77
2019-06-03,545,16,249,265,401,66,78
2019-06-04,547,16,250,266,402,67,78
2019-06-05,548,16,250,266,402,68,78
2019-06-06,551,16,250,266,403,70,78
2019-06-07,551,16,251,267,403,70,78
2019-06-08,552,16,251,267,403,70,79
2019-06-09,552,16,251,267,403,70,79
2019-06-10,552,16,251,267,403,70,79
2019-06-11,551,16,251,267,403,69,79
2019-06-12,551,16,251,267,403,69,79
2019-06-13,553,16,253,269,405,69,79
2019-06-14,553,16,253,269,405,69,79
2019-06-15,554,16,253,269,406,69,79
2019-06-16,554,16,253,269,406,69,79
2019-06-17,554,16,253,269,406,69,79
2019-06-18,554,16,253,269,406,69,79
2019-06-19,554,16,253,269,406,69,79
2019-06-20,555,16,254,270,407,69,79
2019-06-21,555,16,254,270,407,69,79
2019-06-22,556,16,254,270,408,69,79
2019-06-23,556,16,254,270,408,69,79
2019-06-24,557,17,254,271,409,69,79
2019-06-25,557,17,254,271,409,69,79
2019-06-26,560,17,256,273,411,69,80
2019-06-27,562,17,256,273,412,69,81
2019-06-28,563,17,257,274,413,69,81
2019-06-29,564,17,257,274,414,69,81
2019-06-30,564,17,257,274,414,69,81
2019-07-01,565,17,258,275,415,69,81
2019-07-02,565,17,258,275,415,69,81
2019-07-03,565,17,258,275,415,69,81
2019-07-04,566,17,258,275,415,69,82
2019-07-05,566,17,258,275,415,69,82
2019-07-06,566,17,258,275,415,69,82
2019-07-07,566,17,258,275,415,69,82
2019-07-08,566,17,258,275,415,69,82
2019-07-09,567,17,259,276,416,69,82
2019-07-10,567,17,259,276,416,69,82
2019-07-11,567,17,259,276,416,69,82
2019-07-12,568,17,260,277,417,69,82
2019-07-13,568,17,260,277,417,69,82
2019-07-14,569,17,260,277,417,69,83
2019-07-15,569,17,260,277,417,69,83
2019-07-16,569,18,260,278,418,69,82
2019-07-17,569,18,260,278,418,69,82
2019-07-18,570,18,260,278,418,69,83
2019-07-19,571,19,260,279,419,69,83
2019-07-20,571,19,260,279,419,69,83
2019-07-21,571,19,260,279,419,69,83
2019-07-22,572,20,260,280,420,69,83
2019-07-23,573,20,261,281,421,69,83
2019-07-24,574,20,262,282,422,69,83
2019-07-25,574,20,262,282,422,69,83
2019-07-26,574,20,262,282,422,69,83
2019-07-27,574,20,262,282,422,69,83
2019-07-28,574,20,262,282,422,69,83
2019-07-29,575,20,263,283,423,69,83
2019-07-30,575,20,263,283,423,69,83
2019-07-31,575,20,263,283,423,69,83
2019-08-01,576,20,264,284,424,69,83
2019-08-02,577,20,265,285,425,69,83
2019-08-03,578,20,265,285,425,70,83
2019-08-04,578,20,265,285,425,70,83
2019-08-05,578,20,265,285,425,70,83
2019-08-06,579,20,266,286,426,70,83
2019-08-07,580,20,267,287,427,70,83
2019-08-08,580,20,267,287,427,70,83
2019-08-09,581,20,268,288,428,70,83
2019-08-10,581,20,268,288,428,70,83
2019-08-11,581,20,268,288,428,70,83
2019-08-12,581,20,268,288,428,70,83
2019-08-13,583,20,269,289,430,70,83
2019-08-14,584,20,270,290,431,70,83
2019-08-15,585,20,270,290,431,70,84
2019-08-16,590,21,273,294,435,71,84
2019-08-17,591,21,274,295,436,71,84
2019-08-18,592,21,275,296,437,71,84
2019-08-19,592,21,275,296,437,71,84
2019-08-20,593,20,277,297,438,71,84
2019-08-21,593,20,277,297,438,71,84
2019-08-22,594,20,277,297,438,71,85
2019-08-23,594,20,277,297,438,71,85
2019-08-24,594,20,277,297,438,71,85
2019-08-25,594,20,277,297,438,71,85
2019-08-26,594,20,277,297,438,71,85
2019-08-27,594,20,278,298,439,71,84
2019-08-28,595,21,278,299,440,71,84
2019-08-29,597,21,278,299,440,72,85
2019-08-30,598,21,280,301,442,72,84
2019-08-31,601,22,281,303,445,72,84
2019-09-01,602,22,282,304,446,72,84
2019-09-02,603,22,283,305,447,72,84
2019-09-03,604,22,284,306,448,72,84
2019-09-04,605,22,285,307,449,72,84
2019-09-05,605,22,285,307,449,72,84
2019-09-06,605,22,285,307,449,72,84
2019-09-07,606,22,286,308,450,72,84
2019-09-08,606,22,286,308,450,72,84
2019-09-09,606,22,286,308,450,72,84
2019-09-10,606,23,286,309,450,72,84
2019-09-11,608,23,287,310,452,72,84
2019-09-12,608,23,287,310,452,72,84
2019-09-13,610,23,287,310,453,72,85
2019-09-14,611,23,288,311,454,72,85
2019-09-15,611,23,288,311,454,72,85
2019-09-16,611,23,288,311,454,72,85
2019-09-17,614,23,290,313,456,73,85
2019-09-18,615,23,291,314,457,73,85
2019-09-19,615,23,291,314,457,73,85
2019-09-20,615,23,291,314,457,73,85
2019-09-21,615,23,291,314,457,73,85
2019-09-22,615,23,291,314,457,73,85
2019-09-23,617,23,293,316,459,73,85
2019-09-24,618,23,294,317,460,73,85
2019-09-25,619,24,294,318,461,73,85
2019-09-26,621,24,294,318,461,73,87
2019-09-27,625,24,295,319,462,73,90
2019-09-28,625,24,295,319,462,73,90
2019-09-29,626,24,296,320,463,73,90
2019-09-30,627,24,297,321,464,73,90
2019-10-01,628,23,297,320,463,74,91
2019-10-02,628,23,297,320,463,74,91
2019-10-03,628,23,297,320,463,74,91
2019-10-04,629,23,297,320,463,75,91
2019-10-05,629,23,297,320,463,75,91
2019-10-06,629,23,297,320,463,75,91
2019-10-07,631,24,298,322,465,75,91
2019-10-08,630,24,298,322,465,74,91
2019-10-09,630,22,300,322,465,74,91
2019-10-10,631,22,300,322,465,74,92
2019-10-11,634,22,299,321,466,76,92
2019-10-12,635,23,299,322,467,76,92
2019-10-13,635,23,299,322,467,76,92
2019-10-14,646,23,304,327,479,76,91
2019-10-15,651,23,306,329,481,75,95
2019-10-16,652,24,306,330,482,75,95
2019-10-17,652,24,306,330,482,76,94
2019-10-18,652,24,306,330,482,76,94
2019-10-19,652,24,306,330,482,76,94
2019-10-20,652,24,306,330,482,76,94
2019-10-21,654,24,308,332,484,76,94
2019-10-22,654,24,308,332,484,76,94
2019-10-23,654,24,308,332,484,76,94
2019-10-24,655,24,309,333,485,76,94
2019-10-25,656,25,309,334,486,76,94
2019-10-26,655,25,308,333,485,76,94
2019-10-27,655,25,308,333,485,76,94
2019-10-28,656,25,308,333,485,76,95
2019-10-29,656,25,308,333,485,76,95
2019-10-30,655,25,307,332,484,76,95
2019-10-31,656,25,307,332,484,76,96
2019-11-01,658,29,309,338,486,76,96
2019-11-02,658,29,309,338,486,76,96
2019-11-03,660,29,311,340,488,76,96
2019-11-04,661,29,312,341,489,76,96
2019-11-05,662,29,312,341,489,76,97
2019-11-06,663,29,312,341,489,76,98
2019-11-07,663,29,312,341,489,76,98
2019-11-08,662,29,312,341,489,76,97
2019-11-09,663,30,312,342,490,76,97
2019-11-10,663,30,312,342,490,77,96
2019-11-11,663,30,312,342,490,75,98
2019-11-12,664,31,312,343,491,76,97
2019-11-13,665,31,312,343,491,77,97
2019-11-14,666,31,312,343,491,77,98
2019-11-15,672,31,312,343,497,77,98
2019-11-16,672,31,312,343,497,77,98
2019-11-17,672,31,312,343,497,77,98
2019-11-18,672,31,312,343,497,77,98
2019-11-19,673,31,312,343,497,78,98
2019-11-20,673,31,312,343,497,78,98
2019-11-21,673,31,312,343,497,78,98
2019-11-22,674,31,313,344,498,78,98
2019-11-23,675,31,313,344,498,78,99
2019-11-24,677,32,314,346,500,78,99
2019-11-25,677,32,314,346,500,78,99
2019-11-26,679,32,316,348,502,78,99
2019-11-27,690,33,317,350,513,78,99
2019-11-28,690,32,317,349,512,79,99
2019-11-29,685,32,317,349,506,80,99
2019-11-30,685,31,318,349,506,80,99
2019-12-01,686,31,319,350,507,80,99
2019-12-02,688,31,320,351,509,80,99
2019-12-03,689,31,322,353,511,79,99
2019-12-04,689,31,322,353,511,79,99
2019-12-05,690,32,322,354,512,79,99
2019-12-06,691,32,323,355,514,79,98
2019-12-07,695,32,325,357,515,79,101
2019-12-08,695,32,324,356,514,79,102
2019-12-09,695,32,324,356,515,79,101
2019-12-10,696,30,327,357,515,79,102
2019-12-11,696,30,328,358,516,79,101
2019-12-12,689,30,328,358,517,79,93
2019-12-13,690,31,328,359,518,79,93
2019-12-14,690,31,329,360,518,79,93
2019-12-15,690,31,329,360,518,79,93
2019-12-16,691,31,331,362,520,79,92
2019-12-17,691,31,331,362,520,79,92
2019-12-18,690,31,331,362,518,80,92
2019-12-19,691,27,332,359,519,80,92
2019-12-20,694,27,333,360,522,80,92
2019-12-21,700,27,335,362,529,80,91
2019-12-22,700,27,335,362,529,80,91
2019-12-23,701,26,336,362,530,80,91
2019-12-24,707,27,337,364,536,80,91
2019-12-25,706,26,337,363,535,80,91
2019-12-26,706,26,337,363,535,80,91
2019-12-27,707,26,338,364,536,80,91
2019-12-28,713,26,340,366,538,81,94
2019-12-29,713,26,340,366,538,81,94
2019-12-30,712,26,340,366,538,81,93
2019-12-31,713,26,340,366,538,81,94
2020-01-01,713,26,340,366,538,81,94
2020-01-02,713,26,340,366,538,81,94
2020-01-03,722,26,340,366,538,80,104
2020-01-04,724,28,340,368,540,80,104
2020-01-05,726,28,341,369,541,81,104
2020-01-06,726,28,341,369,541,81,104
2020-01-07,727,28,341,369,541,81,105
2020-01-08,728,28,341,369,541,82,105
2020-01-09,729,28,342,370,542,82,105
2020-01-10,731,28,343,371,543,82,106
2020-01-11,732,28,344,372,544,82,106
2020-01-12,732,28,344,372,544,82,106
2020-01-13,733,28,345,373,545,82,106
2020-01-14,733,28,345,373,545,82,106
2020-01-15,730,28,347,375,547,77,106
2020-01-16,732,28,349,377,549,77,106
2020-01-17,731,28,349,377,548,77,106
2020-01-18,733,28,350,378,550,77,106
2020-01-19,733,28,350,378,550,77,106
2020-01-20,734,27,350,377,549,79,106
2020-01-21,735,27,351,378,550,79,106
2020-01-22,735,27,351,378,550,79,106
2020-01-23,737,27,352,379,551,79,107
2020-01-24,739,27,354,381,553,79,107
2020-01-25,740,28,354,382,554,79,107
2020-01-26,740,28,354,382,554,79,107
2020-01-27,740,28,354,382,554,79,107
2020-01-28,741,28,354,382,554,79,108
2020-01-29,742,28,354,382,555,79,108
2020-01-30,742,28,354,382,555,79,108
2020-01-31,743,28,354,382,555,80,108
2020-02-01,743,28,354,382,555,80,108
2020-02-02,744,29,354,383,556,80,108
2020-02-03,744,29,354,383,556,80,108
2020-02-04,744,29,354,383,556,80,108
2020-02-05,744,29,354,383,556,80,108
2020-02-06,744,29,354,383,556,80,108
2020-02-07,745,29,354,383,555,82,108
2020-02-08,746,29,354,383,556,82,108
2020-02-09,746,29,354,383,556,82,108
2020-02-10,746,29,354,383,556,82,108
2020-02-11,746,29,353,382,554,84,108
2020-02-12,746,29,353,382,554,84,108
2020-02-13,746,29,353,382,554,84,108
2020-02-14,746,29,353,382,554,84,108
2020-02-15,747,29,353,382,554,85,108
2020-02-16,747,29,353,382,554,85,108
2020-02-17,746,29,353,382,554,84,108
